XXXXXXXXXXXXXXX
X             X
X XXXXXXXXXXX X
X XS        X X
X XXXXXXXXX X X
X XXXXXXXXX X X
X XXXX      X X
X XXXX XXXX X X
X XXXX XXXX X X
X X    XXXXXX X
X X XXXXXXXXX X
X X XXXXXXXXX X
X XF       X  X
X XXXXXXXXX   X
XFXXXXXXXXXXXXX